****************
****************
****************
****.....a.$****
****#A..*********
****..#A*********
****#A...Pa.$****
****...*********
****...*********
****...*********
****.$.....$****
****************
****************
****************