****************
*#F-----$#G------*
*..j---------#B-*
*c--.g------a.a*
*a.g------.a#C--*
*#B-.d---...c--.*
*.c--b-e----.#B-*
*c--..a.a.a...#A*
*a...i--------.*
*#B-c--c--d---#B-*
*c--.e----d---#A*
*.a..a..P..d---*
*!N-------------*
****************