****************
****************
****************
*****......*****
****....P.$.****
****$..**#B-.****
*****.$.*...****
******#B-...*****
******....******
******.*********
******.*********
****************
****************
****************