****************
****************
****************
***........*****
****....$..*****
*****...#C--*****
******P...******
*******.*a******
*****$...a.$****
****************
****************
****************
****************
****************