****************
****************
******....******
*****.....******
*****.P.*...****
*******.*..$****
*******$*!A******
*********.******
******...$******
******...*******
******.*.*******
***$a...$*******
****************
****************