****************
****************
****************
******......****
****...**.P.****
****...***!A*****
***.....**..****
***..**......***
***...*.$....***
*****$*$********
****************
****************
****************
****************