****************
****************
****************
****************
*****..**..*****
******.....*****
******.P*.$*****
*****..**.******
*****.....******
*****$**$.******
****************
****************
****************
****************