****************
****************
****************
**...........***
**...........***
**......$.a..***
**...$.*!A**$****
**..*!A**...a.***
***....*..**.***
******...*....**
*******P......**
****************
****************
****************