****************
****************
****************
***..*..********
**...*$.....****
**..*#B-.P...a***
**......*.**#A.**
******!A**.a..$**
***********!A****
***********.****
***********$****
****************
****************
****************