****************
****************
****************
***.......******
**....$.P..*****
**...*!B-*...****
*...**..**...***
*..***..***...**
**!A***..****..**
**...d---.***..*
**...****.....**
****************
****************
****************